11111111111111111
1P00000000000C001
10000111110000001
1C000100010000C01
10000111110000001
1000000000000C001
11111110011111111
11111110011111111
1C00000000000C001
10000111110000001
1C000100010000C01
10000111110000001
1000000000000E001
11111111111111111
