1111111111111
1111000CCC0C1
110000C000011
1P000E0001111
1111110111111
1111110111111
11110000000C1
110000C000011
10000C0001111
1111111111111