1111111111111
11110000000C1
110000C000011
1P000E0001111
1111111111111