1111111111111
1111000CCC001
1100000000011
10000C0001111
1100011111111
11E0000001111
11110000000C1
110000C000011
10000C0P01C11
1111111111111