111111
1P0C01
100X01
1C0E01
111111
