111111
1P0001
100001
100E01
111111
