1111111
1P0C01
100001
1C0E0111
1111111
