111111
1P0C01
1P0001
1C0E01
111111
