111111
1P0C01
111111
110E01
111111
