1111111111
1P00011C01
1011010101
1000010101
11110001C1
100001E001
1111111111
